################
################
###...#...#...##
###LK.D.B.#.M.##
###...#...#...##
####D#######D###
###...#.K.#..K##
###....H..D.P.##
###..K#...#...##
####F###D#######
###...#...#...##
###...D...D.M.##
###...#S.K#...##
################
################
################