#######D########
#######P########
#M#F..S.B...F#M#
#M#M...K.M..F#.#
#M#.........F#M#
#.#..........#M#
#.#F..MM..H.M#.#
#M#.......F..#M#
#.#.....M...M#M#
#M#F........F#.#
########D#######
########.#######
#######...L#####
#######....#####
#######....#####
################