################
################
########.....###
########.###.###
#######F.S##...#
###........D.MK#
###..##M.F##..H#
##K..##......###
###..#....######
###DD#...M######
###..#..B.######
##K..##.S.######
##...##...#...##
###.....P...L.##
################
################