################
################
################
########.....###
#....###L....###
#..H.#####...FK#
#....###.......#
#....###M....###
###D####.#######
#..............#
#.....P.....S..#
#...B..........#
#..............#
################
################
################
tab opens editor