################
###B........M###
###...#B.K.#.###
###...#.L.##B###
###....M.D....##
####..#####...##
####.....D....##
##F########...##
##P...........##
##..##B####MFF##
#S.S##D..F#...##
#........##SBS##
#....###M.....##
#....K...##...##
#........##K.H##
################