################
#....#....#....#
#.B..D.HK.D..S.#
#....M....F.K..#
#....#....#....#
##MF###DD###MM##
#....#....#....#
#..K.D..P.F..B.#
#.B..F.K..D.S..#
#....#....#....#
##FF###DM###DM##
#....#....#....#
#..B.M..K.F.S..#
#.S..D.S..D..B.#
#....#....#...LD
################