################
#.B..#####.....#
#.#.S##.H...#..#
#....##..#..#.K#
#.....#..#.B#..#
#..#..#..#....##
#.....#.M.....##
####..####..####
##P....DF.....L.
####..####..####
#S#...F##...####
#......##.F..###
#.M...###....###
#..K..DS#....###
#S#.F.##########
################