####DD##########
####..##.L.#####
####...D...#####
####..##..L#####
####MM##########
#F.....F..F....#
##........##...#
##..#.....##...#
##.##.....##.H.#
##..########...#
##.S.#######...#
##..####.......#
##SS.FD........#
##..####..K#...#
##.P.L##.......#
################