################
################
################
##....S##....L##
##.....##.....##
##......F.....##
##.....##..H..##
##.....##.....##
####.###########
####.###########
####M###########
##.....##.....##
##.B....D...P.##
##.....##.K...##
################
################
reset with space