################
####........M###
####..###.K#.###
####..##L..#B###
####...M.BD...##
####..#####...##
####.....D....##
##F########...##
##P...........##
##..##B####MFF##
#S.S##D..F#...##
#........##SBS##
#....###M.....##
#...K....##...##
#........##K.H##
################