################
#######...#...##
#######.H.#.B.##
#######...#...##
#B..P.##D###D###
###.M.....K...##
###...........##
###..####.##.###
###..####K.#L###
##F......S.#.###
##.###M###.M.###
#....#.......###
#M..#######.####
#.KB.D..S.FB####
#....#....F.####
################