################
#.....D...######
#..####...######
#..####...######
#....##...######
#.H...D...M.L...
#....##...######
#######..#######
####KF.......###
########..#..###
########.....###
####....S.######
####..#...######
####..#..B######
####....P.######
#########D######